⌜------⎤⎡-----
⎸••••••][•••••
⎸⦾⌌⎽⎽⌍•][•⌌⎽⎽⎽
⎸•⌎⎺⎺⌏•⌎⌏•⌎⎺⎺⎺
⎸•••••••••••••
⌞_⌍•⌌⌍•⌌⎽⎽⎽⌍•⌌
  ⎸•][•]▓▓▓[•]
--⌏•][•⌎⎺⎺⎺⌏•]
   •][•••••••]
__⌍•]⎩⎽⎽⌍ ⌌⎽⎽⎭
  ⎸•⌎⎺⎺⎺⌏ ⌎⎺⎺⎺
  ⎸•          
  ⎸•⌌⎽⎽⎽⌍ 「_>*
  ⎸•]⎧⎺⎺⌏ ⎹   
  ⎸•][    ⎹   
  ⎸•][ ⌌⌍ ⎹   
--⌏•⌎⌏ ][ ﹂---
   •   ][     
__⌍•⌌⎽⎽⎭⎩⎽⎽⌍ ⌌
  ⎸•⌎⎺⎺⎺⎺⎺⎺⌏ ]
  ⎸•••••••   ]
  ⎸•⌌⎽⎽⎽⌍•⌌⎽⎽⎭
⌜-⌏•⌎⎺⎺⎺⌏•⌎⎺⎺⎺
⎸•••••••••••• 
⎸•⌌⎽⎽⌍•⌌⎽⎽⎽⌍•⌌
⎸•]▓▓[•]⎧⎺⎺⌏•]
⎸•]▓▓[•][••••]
⎸⦾]▓▓[•][•⌌⎽⎽⎭
⎸•⌎⎺⎺⌏•⌎⌏•⌎⎺⎺⎺
⎸•••••••••••••
⌞_____________